qi yan a gu la|Qǐyán Āgǔlā
qi yan|Qí Yán
fu ma|Fùmǎ
zhen zhen|Zhēnzhēn
er yuan yi hua|Èr Yuán Yī Huā
mu yang ju shi|Mùyáng Jūshì
nan gong jing nu|Nángōng Jìngnǚ
jing nu|Jìngnǚ
nan gong rang|Nángōng Ràng
nan gong su nu|Nángōng Sùnǚ
chiong hua|Qiónghuá
nan gong shu nu|Nángōng Shūnǚ
zhuo hua|Zhuóhuá
nan gong ping|Nángōng Píng
nan gong wei|Nángōng Wēi
nan gong wang|Nángōng Wàng
nan gong zhen|Nángōng Zhèn
nan gong da|Nángōng Dá
nan gong lie|Nángōng Liè
nan gong li|Nángōng Lí
qi yan no min|Qǐyán Nuòmǐn
xiao die|Xiǎo Dié
no min|Nuòmǐn
gu qi ba yin|Gǔqí Bāyīn
ba yin|Bāyīn
qi yan sukh ba ru|Qǐyán Sūkhbārǔ
fu rong|Fúróng
nag si ji ya|Nàgsī Jíyǎ
ji ya|Jíyǎ
nag si a nu jin|Nàgsī Ānǔjīn
nag si e ri he|Nàgsī Érìhé
li yan ru|Lǐ Yánrú
ding you|Dīng Yǒu
gong yang huai|Gōngyáng Huái
gong yang bai shi|Gōngyáng Báishí
bai shi|Báishí
shang guan wu|Shàngguān Wǔ)
lu zhong xing|Lù Zhòngxíng
chun tao|Chūntáo
qiu ju|Qiūjú
ding feng shan|Dīng Fèngshān
ding yi|Dīng Yí
lu bo yan|Lù Bóyán
lu quan|Lù Quán
nan gong bao|Nángōng Bǎo
si jiu|Sìjiǔ
wu da|Wǔ Dà
xia he|Xiàhé
xie an|Xiè Ān
xie yuan shan|Xiè Yuǎnshān
yuan shan|Yuǎnshān
